C 255,255,255

NO ./textures/arrow.xpm
SO ./textures/arrow.xpm
EA ./textures/arrow.xpm
WE ./textures/arrow.xpm

F 50,50,50


       11111111111111
       10000000000001
       10000000000001
       10000000000001
1111111100000000000011111111
1000000000000000000000000001
1000010000010000111111000001
1000001000100000100000100001
1000000101000000000000010001
10000000100000N0100000100001
1000000100000000111111000001
1000001000000000100000000001
1000010000000000100000000001
1000100000000000100000000001
1111111100000000000011111111
       10000000000001
       10000000000001
       10000000000001
       11111111111111
