NO ./textures/brick_wall_cracked.xpm
SO ./textures/greystone.xpm
EA ./textures/brick_wall.xpm
WE ./textures/grass.xpm

C 255,255,255
F 50,50,50

1111111111111111111111111111111
1000000000100000000000000000001
1011111010111111111111101111101
1010000000000000000000100000101
1010111111111110111110111110101
1000100000000010100000000010001
1111101111111010101111111010111
1000000000001000101000000010001
1011111111101111101011111110101
1010000000000000001010000000101
1010111111111111101010111111101
1000100000000000101000100000001
1111101111111110101111101111111
1000001000000010100000001000001
1011111011111010101111111011101
1000000000001000100000000000101
1111111111101111111111111110101
1000000000100000000000000010001
1011111110111111111111111010111
1010000000000000000000001000001
1010111111111111111111101111101
1000100000000000000000100000101
1111101111111111111110111110101
1000000000000000000010000010001
1011111111111111111010111110111
1000000000000000001000100000001
1111111111111111101111101111101
1000000000000000100000001000101
1011111111111110111111111010101
10000000000000100000000000000W1
1111111111111111111111111111111
