NO ./textures/grass.xpm
SO ./textures/grass.xpm
EA ./textures/grass.xpm
WE ./textures/grass.xpm

C 255,255,255
F 50,50,50


1111111111111111111111111111111111111111111111111111111111111111111111111111111111111111111111111111111111111111111111111111111111111111111111111111111111111111111111111111111111111111111
1111111111111111111111111111111111111111111111111111111111111111111111111111111111111111111111111111111111111111111111111111111111111111111111111111111111111111111111111111111111111111111
1111111111111111111111111111111111111111111111111111111111111111111111111111111111111111111111111111111111111111111111111111111111111111111111111111111111111111111111111111111111111111111
1111111111111111111111111111111111111111111111111111111111111111111111111111111111111111111111111111111111111111111111111111111111111111111111111111111111111111111111111111111111111111111
1111111111111111111111111111111111111111111111111111111111111111111111111111111111111111111111111111111111111111111111111111111111111111111111111111111111111111111111111111111111111111111
1111111111111111111111111111111111111111111111111111111111111111111111111111111111111111111111111111111111111111111111111111111111111111111111111111111111111111111111111111111111111111111
1111111111111111111111111111111111111111111111111111111111111111111111111111111111111111111111111111111111111111111111111111111111111111111111111111111111111111111111111111111111111111111
1111111111111111111111111111111111111111111111111111111111111111111111111111111111111111111111111111111111111111111111111111111111111111111111111111111111111111111111111111111111111111111
1111111111111111111111111111111111111111111111111111111111111111111111111111111111111111111111111111111111111111111111111111111111111111111111111111111111111111111111111111111111111111111
1111111111111111111111111111111111111111111111111111111111111111111111111111111111111111111111111111111111111111111111111111111111111111111111111111111111111111111111111111111111111111111
1111111111111111111111111111111111111111111111111111111111111111111111111111111111111111111111111111111111111111111111111111111111111111111111111111111111111111111111111111111111111111111
1111111111111111111111111111111111111111111111111111111111111111111111111111111111111111111111111111111111111111111111111111111111111111111111111111111111111111111111111111111111111111111
1111111111111111111111111111111111111111111111111111111111111111111111111111111111111111111111111111111111111111111111111111111111111111111111111111111111111111111111111111111111111111111
1111111111111111111111111111111111111111111111111111111111111111111111111111111111111111111111111111111111111111111111111111111111111111111111111111111111111111111111111111111111111111111
1111111111111111111111111111111111111111111111111111111111111111111111111111111111111111111011111011111111111111111111111111111111111111111111111111111111011111111111111111111111111111111
1111111111111111111111111111111111111111111111111111111111111111111111111111111111110000000000000000000111111111111111111111111111111111111111111111111111000001111111111111111111111111111
1111111111111111111111111111111111111111111111111111111111111111111111111111111100000000000000000000000000001111111111111111111111111111111111111111111111011111111111111111111111111111111
1111111111111111111111111111111111111111111111111111111111111111111111111111000000000000000000000000000000000001111111111111111111111111111111111111111110011011011111111111111111111111111
1111111111111111111111111111111111111111111111111111111111111111111111111100000000000000000000000000000000000000001111111111111111111111111111111111111110011000100111111111111111111111111
1111111111111111111111111111111111111111111111111111111111111111111111100000000000000000000000000000000000000000000010111111111111111111111111111111111100011000010011111111111111111111111
1111111111111111111110011111111111111111111111111111111111111111111110000000000000000000000000000000000000000000000000011111111111111111111111111111111100001100011001111111111111111111111
1111111111111111111111001111111111111111111111111111111111111111111100000000000000000000000000000000000000000000000000000111111111111111111111111111111000000110001110001111111111111111111
1111111111111111110011100111111111111111111111111111111111111111110000000000000000000000000000000111101111111000000000000001111111111111111111111111110000000011011110001111111111111111111
1111111111111111101101100011111111111111111111111111111111111111100000000000000000000000000010110000111111111010110000000000111111111111111111111111100000000000000000001111111111111111111
1111111111111111011001100011111111111111111111111111111111111110000000000000000000000000111000001111011111111101111100000000001111111111111111111110000000000000000000001111111111111111111
1111111111111110010010000001111111111111111111111111111111111111111111111100000000000000000111101111011100000011111111000000000111111111111111111100000000011001110000111111111111111111111
1111111111111101000011000000111111111111111111111111111111110000000000000000000000000001011111111110000000000000111111110000000001111111111111110000000011111111111111111111111111111111111
1111111111111001001110000000011111111111111111111111111111011101100000000000000000000001111110100000000000000000000000110000000000111111111111000000001111111111111111111111111111111111111
1111111111111001110000000000000111111111111111111111011111111111111001000000000000000000110000000000000000000000000000011000000000011111111100000000111111111111111111111111111111111111111
1111111111100000000000000000000001111111111111111111111111111110110100000000000000000000000000000000000000000000000000000000000000110111100000000011111111111111111111111111111111111111111
1111111111111000000110101100000000011111111111111101100000000000000011000000000000000000000000000000000000000000000000000000000000000000000000000111111111111111111111111111111111111111111
1111111111111111111111111111100000000011111111111100000000000000000000000000000000000000000000000000000000000000000000000000000000000000000000011111111111111111111111111111111111111111111
1111111111111111111111111111111100000000011111110000000000000000000000000000000000N00000000000000001111111111010000000000000000000000000000000111111111111111111111111111111111111111111111
1111111111111111111111111111111111000000000000100000000000000000000000000000000000000000000000000110011101111110110000000000000000000000000001111111111111111111111111111111111111111111111
1111111111111111111111111111111111110000000011000000000000000011111000000000000000000000000000011010111111000001111100000000000000000000000011111111111111111111111111111111111111111111111
1111111111111111111111111111111111111100000010000000000000011101110111100000000000000000000000101110011111101111100110000000000000000000000011111111111111111111111111111111111111111111111
1111111111111111111111111111111111111110000000100000000001111100000110111000000000000000000001011110011111100010111111111000000000000000000111111111111111111111111111111111111111111111111
1111111111111111111111111111111111111111100000100000000111110011011010001100000000000000000001111000000111111110001111111100000000000000001111111111111111111111111111111111111111111111111
1111111111111111111111111111111111111111110000100000001111111111100111110100000000000000000011010000011001111011111100000000000000000000000111111111111111111111111111111111111111111111111
1111111111111111111111111111111111111111111111000000011111000001110111100111011011110110110001101111101111110000001111111110000000000000000111111111111111111111111111111111111111111111111
1111111111111111111111111111111111111111111101000000011110000110111111100100100000000000001111111111111111111110110000000000000000000000001111111111111111111111111111111111111111111111111
1111111111111111111111111111111111111111111111000011110110000001000111100100000000000000000001010111000000000000000000000000000000000000000111111111111111111111111111111111111111111111111
1111111111111111111111111111111111111111111111000001000011111111111111100000000000000000000000000000111000000000000000000000000000000000000011111111111111111111111111111111111111111111111
1111111111111111111111111111111111111111111110000101111111100011101001000000000000000000000000000000001100000000000000000000000000000000000000111111111111111111111111111111111111111111111
1111111111111111111111111111111111111111111100000000000000000000111110000000000000000000000000000000000010000000000000000000000000000000000000011111111111111111111111111111111111111111111
1111111111111111111111111111111111111111111000000000000000000001100000000000000000000000000000000000000011000000000000000000000000000000000000001111111111111111111111111111111111111111111
1111111111111111111111111111111111111111110000000000000000000001000000000000000000000000000000000000000001100000000000000000000000000000000000000111111111111111111111111111111111111111111
1111111111111111111111111111111111111111100000000000000000000110000000000000000000000000000000000001000011000000000000000000000000000000000000000011111111111111111111111111111111111111111
1111111111111111111111111111111111111111000000000000000000000010000000000000000000000000000000001111110001000001100000000000000000000000000000000011111111111111111111111111111111111111111
1111111111111111111111111111111111111110000000000000000000000110001110000000000000000000000000011111111010000000001111000000000000000000000000000000111111111111111111111111111111111111111
1111111111111111111111111111111111111100000000000000000000000011011111100000000000000000000001011111110000000000000000111011000000000000000000000001111111111111111111111111111111111111111
1111111111111111111111111111111111111100000000000000000000001101111111110100000000000000000100000000000000000000000000000011111101000000000000000000011111111111111111111111111111111111111
1111111111111111111111111111111111110000000000000000000000011000011111000111100000000000101000000000000000000000000000000011111101110000000000000000111111111111111111111111111111111111111
1111111111111111111111111111111111111000000000000000000001100000000000000000011110110110000000000000000000000000000000000110000110011000000000000000011111111111111111111111111111111111111
1111111111111111111111111111111111110000000000000000000110000000000000000000000000000000000000000000000000000000000000011000000010000000000000000000011111111111111111111111111111111111111
1111111111111111111111111111111111100000000000000000111000000000000000000000000000011000000000000000000000000000000001010000000000000000000000000000011111111111111111111111111111111111111
1111111111111111111111111111111111110000000000000111100000000000000000000000000000001000000000000000000000000000000101000000000000000000000000000000011111111111111111111111111111111111111
1111111111111111111111111111111111110000000000011110000000000000000000000000000000000000000000000000000000000000011100000000000000000000000000000000011111111111111111111111111111111111111
1111111111111111111111111111111111110000000000111111100000000000000000000000000000000000000000000000000000000010100000000000000000000000000000000000011111111111111111111111111111111111111
1111111111111111111111111111111111110000000000110000011100000000000000000000000000001000000000000000000000110100000000000000000000000000000000000000011111111111111111111111111111111111111
1111111111111111111111111111111111111000000000110000000011100000000000000000000000000100000000000000000111000000000000000000000000000000000000000000011111111111111111111111111111111111111
1111111111111111111111111111111111111000000000010000000000111110000000000000000000000000000000000011011000000000000000000000000000000000000000000000011111111111111111111111111111111111111
1111111111111111111111111111111111111000000000000000000000000011101111100000000000000000000001101100000000000000000000000000000000000000000000000000111111111111111111111111111111111111111
1111111111111111111111111111111111111100000000000000000000000000000000111110101111111110111100000000000000000000000000000000000000000000000000000000111111111111111111111111111111111111111
1111111111111111111111111111111111111110000000000000000000000000000000000000000000000000000000000000000000000000000000000000000000000000000000000000111111111111111111111111111111111111111
1111111111111111111111111111111111111110000000000000000000000000000000000000000000000000000000000000000000000000000000000000000000000000000000000001111111111111111111111111111111111111111
1111111111111111111111111111111111111111000000000000000000000000000000000000000000000000000000000000000000000000000000000000000000000000000000000011111111111111111111111111111111111111111
1111111111111111111111111111111111111111100000000000000000000000000000000000000001111011111110111000000000000000000000000000000000000000000000000011111111111111111111111111111111111111111
1111111111111111111111111111111111111111110000000000000000000000000000000000011100000000000000000000000000000000000000000000000000000000000000000111111111111111111111111111111111111111111
1111111111111111111111111111111111111111110000000000000000000000000000000000000000000000000000000000000000000000000000000000000000000000000000001111111111111111111111111111111111111111111
1111111111111111111111111111111111111111111000000000000000000000000000000000000000000000000000000000000000000000000000000000000000000000000000011111111111111111111111111111111111111111111
1111111111111111111111111111111111111111111110000000000000000000000000000000000000000000000000000000000000000000000000000000000000000000000001111111111111111111111111111111111111111111111
1111111111111111111111111111111111111111111111000000000000000000000000000000000000000000000000000000000000000000000000000000000000000000000011111111111111111111111111111111111111111111111
1111111111111111111111111111111111111111111111100000000000000000000000000000000000000000000000000000000000000000000000000000000000000000001111111111111111111111111111111111111111111111111
1111111111111111111111111111111111111111111111110000000000000000000000000000000000000000000000000000000000000000000000000000000000000000111111111111111111111111111111111111111111111111111
1111111111111111111111111111111111111111111111111100000000000000000000000000000000000000000000000000000000000000000000000000000000000011111111111111111111111111111111111111111111111111111
1111111111111111111111111111111111111111111111111110000000000000000000000000000000000000000000000000000000000000000000000000000000001111111111111111111111111111111111111111111111111111111
1111111111111111111111111111111111111111111111111111100000000000000000000000000000000000000000000000000000000000000000000000000000111111111111111111111111111111111111111111111111111111111
1111111111111111111111111111111111111111111111111111111000000000000000000000000000000000000000000000000000000000000000000000000111111111111111111111111111111111111111111111111111111111111
1111111111111111111111111111111111111111111111111111111110000000000000000000000000000000000000000000000000000000000000000000011111111111111111111111111111111111111111111111111111111111111
1111111111111111111111111111111111111111111111111111111111100000000000000000000000000000000000000000000000000000000000000001111111111111111111111111111111111111111111111111111111111111111
1111111111111111111111111111111111111111111111111111111111111000000000000000000000000000000000000000000000000000000000000111111111111111111111111111111111111111111111111111111111111111111
1111111111111111111111111111111111111111111111111111111111111110000000000000000000000000000000000000000000000000000000001111111111111111111111111111111111111111111111111111111111111111111
1111111111111111111111111111111111111111111111111111111111111111100000000000000000000000000000000000000000000000000000111111111111111111111111111111111111111111111111111111111111111111111
1111111111111111111111111111111111111111111111111111111111111111111000000000000000000000000000000000000000000000000011111111111111111111111111111111111111111111111111111111111111111111111
1111111111111111111111111111111111111111111111111111111111111111111110000000000000000000000000000000000000000000111111111111111111111111111111111111111111111111111111111111111111111111111
1111111111111111111111111111111111111111111111111111111111111111111111111000000000000000000000000000000000011111111111111111111111111111111111111111111111111111111111111111111111111111111
1111111111111111111111111111111111111111111111111111111111111111111111111111111110000000000000011111111111111111111111111111111111111111111111111111111111111111111111111111111111111111111
1111111111111111111111111111111111111111111111111111111111111111111111111111111111111111111111111111111111111111111111111111111111111111111111111111111111111111111111111111111111111111111
1111111111111111111111111111111111111111111111111111111111111111111111111111111111111111111111111111111111111111111111111111111111111111111111111111111111111111111111111111111111111111111
1111111111111111111111111111111111111111111111111111111111111111111111111111111111111111111111111111111111111111111111111111111111111111111111111111111111111111111111111111111111111111111
