NO ./textures/grass.xpm
SO ./textures/grass.xpm
EA ./textures/grass.xpm
WE ./textures/grass.xpm

C 119,180,255
F 50,50,50
       
      111
111111101
10000W001
100000001
100000001
111111111
