NO ./grass.xpm
SO ./grass.xpm
EA ./grass.xpm
WE ./grass.xpm

C 255,255,255
F 22,255,255

       111111111111111111111111111111111
       1S0000000000000000000000000000001
       100000000000000000000000000000001
1111111100000000000000000000000000000001
1000000000000000000000000000000000000011
1000000000000000000000000000000000000011
1000000000000000000000000000000000000011
1000000000000000000000000000000000000011
1000010000000000000000000000000000000001
1000010000000000000000000000000000000001
1000010000000000000000000000000000000001
1000010000000000000000000000000000000001
1000010000000000000000000000000000000001
1000010000000000000000000000000000000001
1000010000000000000000000000000000000001
1000010000000000000000000000000000000001
1000010000000000000000000000000000000001
1000010000000000000000000000000000000001
1000010000000000000000000000000000000001
1000111100000000000000000000000000000001
11111  111111111111111111111111111111111
