NO ./grass.xpm
SO ./grass.xpm
EA ./grass.xpm
WE ./grass.xpm

C 255,255,255
F 50,50,50

       11111111111111
       10000000000001
       10000000000001
       10000000000001
1111111100000000000011111111
1000000000000000000000000001
1000000000000000000000000001
1000000000000000000000000001
1000000000000000000000000001
10000000000000N0000000000001
1000000000000000000000000001
1000000000000000000000000001
1000000000000000000000000001
1000000000000000000000000001
1111111100000000000011111111
       10000000000001
       10000000000001
       10000000000001
       11111111111111
