NO ./grass.xpm
SO ./grass.xpm
EA ./grass.xpm
WE ./grass.xpm

C 255,255,255
F 22,255,255

       11111111111111
       1S000000000001
       10000000000001
111111110000000000001
100000000000000000011
100000000000010000011
100000000000000000011
111111111111111111111

