NO ./grass.xpm
SO ./grass.xpm
EA ./grass.xpm
WE ./grass.xpm

C 255,255,255
F 22,255,255

       11111111111111
       10000000000001
       10000000000001
       10000000000001
1111111100000000000011111111
1000000000000000000000000001
1000000000000000000000000001
1000000000000000000000000001
1000000000000000000000000001
10000000000000S0000000000001
1000000000000000000000000001
1000000000000000000000000001
1000000000000000000000000001
1000000000000000000000000001
1111111100000000000011111111
       10000000000001
       10000000000001
       10000000000001
       11111111111111
