NO ./grass.xpm
SO ./grass.xpm
EA ./grass.xpm
WE ./grass.xpm

C 255,255,255
F 22,255,255

       1111111
       1000001
       1000001
11111111000001
10000100000S0011
10000100000001
10001111000001
11111  1111111