NO ./grass.xpm
SO ./grass.xpm
EA ./grass.xpm
WE ./grass.xpm

C 255,255,255
F 22,255,255

       111111111111111111111111111111111
       100000000000000000000000000000001
       100000000000000000000000000000001
1111111100000000000000000000000000000001
1000000000000000000000000000000000000011
1000000000000000000000000000000000000011
1000000000000000000000000000000000000011
1000000000000000000000000000000000000011
1000010000000000000000000000000000000001
1000010000000000000000000000000000000001
1000010000000000000000000000000000000001
1000010000000000000000000000000000000001
1000010000000000000000000000000000000001
1000010000000000000000000000000000000001
1000010000000000000000000000000000000001
1000010000000000000000000000000000000001
1000010000000000000000000000000000000001
1000010000000000000000000000000000000001
1000010000000000000000000000000000000001
10001111000000000000000000000000000000W1
11111  111111111111111111111111111111111
